1111111111111111111111111111111111
100000000000000C00000C0000E0000001
1010010100100000101001000000010101
1010010010101010001001000000010101
1P0000000C00C0000000000011100000C1
1000001100000000010001111110000001
100010000110001000000111C0001C1001
1111111111111111111111111111111111