1111111111111111111111111111111111
1000000000111000000000000000000001
1C11111000000000001010111100000001
1111111001111100001C1000C100000001
10000000000001000011101111000C0001
1011010C000C01000000101C0000000001
10P1010000000100CC0010111100000001
1111011111100100000000000001011111
1000000000100000000000000001000001
10111111111000C0CC0C00011111111101
100000000C10000000000001E000000001
1111111111111111111111111111111111