1111111111111111111
1E0000000P00000C001
1010010100100000101
1111111111111111111